NO ./TEXTURES/north.xpm
SO   ./TEXTURES/south.xpm
  
      

WE ./TEXTURES/west.xpm

EA ./TEXTURES/east.xpm
F 220,100,0
C 225,30,0



    1111111
 1   101 101
1011  1   1
1011
1W01
1111
