NO ./TEXTURES/north.xpm
SO ./TEXTURES/south.xpm
WE ./TEXTURES/west.xpm
EA ./TEXTURES/east.xpm
F 220,100,0
C 225,30,0
1111
1001
1011
1001
1N01
1001
1111
