NO ./TEXTURES/north.xpm
SO ./TEXTURES/south.xpm
WE ./TEXTURES/west.xpm
EA ./TEXTURES/east.xpm
F 182,111,5
C 135,206,235
111111111
100000001
100000001
100101001
110100001
100000001
100101001
110100001
100000001
100101001
110100001
100000001
100101001
110100001
100000001
100111001
1101N0001
111111111
